                                                     ****         
                            ******                 ********       
                          **********            *************     
                        ******  ******       *******     ******   
                      *****       **************           ****  
                     *****           **********              **** 
                   ******              ******               ***** 
                  ******                                    ***** 
                 ffffff                                  *******   
                ffffff                           ***************    
              ffffff                         *****************     
                                         **************
                                        ******                      
 sssss                                 ****                        
 *****                                ****                        
 ******                               ****                       
  ******                 *****         ****                       
    ******             ********         ****                      
      *****            *********         ****                     
        ****          ****   ****         ****                    
         ****         ***     ****         ****                   
          ****       ****       *****      *****                   
           ****      ****         ******  ******                   
            ************           *************                    
              *********              **********                     
               *******                 ******                       
